216  12  48
0  0  0  0  0  0  0  0  0  0  0  0  0  0  0  0  0  0  0  0  0  0  0  0  0  0  0  0  0  0  0  0  0  0  0  0  0  0  0  0  0  1  2  3  2  3  4  5  
0  6  7  8  7  8  7  8  7  8  7  9  0  0  0  0  0  0  10  11  10  11  10  11  10  11  10  11  0  0  0  0  0  0  0  0  0  0  0  0  12  13  14  15  14  15  16  17  
18  19  20  21  20  21  20  21  20  21  20  22  0  0  0  0  23  24  25  26  25  26  25  26  25  26  25  26  0  0  0  0  0  0  0  0  0  0  0  0  27  28  29  30  31  30  32  33  
34  35  34  35  34  35  34  35  34  35  34  36  37  38  37  38  39  40  39  40  39  40  39  40  39  40  39  40  37  38  37  38  37  38  37  38  41  42  41  42  43  44  45  46  47  46  48  49  
50  51  52  53  50  53  50  53  50  53  50  54  55  56  55  56  57  58  59  58  57  58  57  58  57  58  57  58  55  56  55  56  55  56  55  56  60  61  60  61  62  63  64  65  66  67  68  69  
70  71  72  73  70  74  70  74  70  74  70  74  75  76  75  76  75  76  77  78  75  76  75  76  75  76  75  76  75  76  75  76  75  76  75  76  79  80  81  80  82  83  84  85  86  87  88  89  
90  91  92  93  90  94  90  94  90  94  90  94  95  96  95  96  95  96  97  98  95  96  95  96  95  96  95  96  95  96  95  96  95  96  95  96  99  100  101  100  44  102  103  104  105  106  107  108  
109  110  111  112  109  113  109  113  109  113  109  113  114  115  114  115  114  115  116  44  114  115  114  115  114  115  114  115  114  115  114  115  114  115  114  115  117  44  118  44  44  119  120  121  119  122  123  124  
125  126  127  128  125  126  125  126  125  126  125  126  129  130  129  130  129  130  131  132  129  130  129  130  129  130  129  130  129  130  129  130  129  130  129  130  133  134  44  44  44  135  136  137  138  139  140  141  
142  143  144  145  146  44  142  143  142  143  146  44  147  148  147  44  147  148  149  150  147  44  147  148  147  148  147  44  151  148  147  44  147  44  147  44  152  153  44  44  44  154  155  44  154  156  157  158  
159  160  161  162  163  164  159  165  159  166  163  164  167  168  169  169  167  168  170  171  169  169  167  168  167  168  169  169  167  168  169  169  169  169  172  173  174  175  176  177  178  179  180  181  182  183  184  185  
186  187  188  189  190  191  192  193  192  194  190  191  195  196  197  198  195  199  200  201  198  198  195  199  195  196  197  198  195  196  197  198  198  198  202  203  204  205  206  207  208  209  210  211  212  213  214  215  